15
1 2 2 12 3 5 4 11 5 19 6 1 7 16 8 7 9 7 10 9 11 12 12 14 13 12 14 7 -1 -1
0 2 2 14 3 16 4 7 5 7 6 1 7 13 8 18 9 12 10 10 11 16 12 13 13 19 14 16 -1 -1
0 12 1 14 3 1 4 14 5 12 6 12 7 5 8 13 9 7 10 20 11 9 12 7 13 15 14 15 -1 -1
0 5 1 16 2 1 4 12 5 5 6 10 7 20 8 2 9 9 10 14 11 20 12 14 13 12 14 20 -1 -1
0 11 1 7 2 14 3 12 5 15 6 14 7 19 8 12 9 11 10 2 11 12 12 17 13 4 14 7 -1 -1
0 19 1 7 2 12 3 5 4 15 6 1 7 7 8 3 9 19 10 20 11 7 12 6 13 3 14 18 -1 -1
0 1 1 1 2 12 3 10 4 14 5 1 7 14 8 2 9 17 10 10 11 14 12 3 13 19 14 15 -1 -1
0 16 1 13 2 5 3 20 4 19 5 7 6 14 8 15 9 14 10 4 11 10 12 2 13 5 14 14 -1 -1
0 7 1 18 2 13 3 2 4 12 5 3 6 2 7 15 9 17 10 20 11 4 12 6 13 16 14 1 -1 -1
0 7 1 12 2 7 3 9 4 11 5 19 6 17 7 14 8 17 10 12 11 13 12 3 13 2 14 20 -1 -1
0 9 1 10 2 20 3 14 4 2 5 20 6 10 7 4 8 20 9 12 11 3 12 6 13 2 14 13 -1 -1
0 12 1 16 2 9 3 20 4 12 5 7 6 14 7 10 8 4 9 13 10 3 12 2 13 1 14 7 -1 -1
0 14 1 13 2 7 3 14 4 17 5 6 6 3 7 2 8 6 9 3 10 6 11 2 13 19 14 4 -1 -1
0 12 1 19 2 15 3 12 4 4 5 3 6 19 7 5 8 16 9 2 10 2 11 1 12 19 14 3 -1 -1
0 7 1 16 2 15 3 20 4 7 5 18 6 15 7 14 8 1 9 20 10 13 11 7 12 4 13 3 -1 -1
