15
4 15 2 7 7 10 -1 -1
7 8 13 6 6 13 -1 -1
0 7 -1 -1
14 11 9 8 8 6 13 12 4 2 -1 -1
0 15 3 2 5 8 -1 -1
4 8 6 5 7 1 8 8 9 9 -1 -1
1 13 5 5 -1 -1
0 10 1 8 5 1 8 10 9 8 10 5 -1 -1
3 6 5 8 7 10 14 3 11 7 12 9 -1 -1
3 8 5 9 7 8 -1 -1
7 5 14 12 12 4 13 13 -1 -1
8 7 13 12 14 10 12 14 -1 -1
8 9 10 4 11 14 13 7 14 6 -1 -1
1 6 3 12 10 13 11 12 12 7 -1 -1
3 11 8 3 10 12 11 10 12 6 -1 -1
